Aachen	AAC
Anhalt	ANH
Ansbach	ANS
Augsburg	AUG
Bamberg	BAM
Bayreuth	BYT
Bregenz	MBZ
Bremen	BRE
Brunswick	BRU
Cilli	CLI
Dithmarschen	DTT
Dortmund	RVA
Frankfurt	FRN
Geneva	GNV
Goslar	GOS
Hamburg	HAM
Konstanz	KNZ
Landshut	LBV
Lübeck	HSA
Lüneburg	LUN
Memmingen	MEM
Mulhouse	MLH
Nassau	NSA
Nuremberg	NUM
Oldenburg	OLD
Passau	PSS
Regensburg	REG
Rothenburg	ROT
Salzburg	SLZ
Saxe-Lauenburg	LAU
Strasbourg	ALS
Trent	TNT
Ulm	ULM
Verden	VER
Wurttemberg	WUR
Wurzburg	WBG